


NO ./textures/simonkraft/cobblestone.xpm
C 99,99,99
SO ./textures/simonkraft/cobblestone_01.xpm
WE ./textures/simonkraft/mossy_cobblestone1.xpm
F 76,76,76
EA ./textures/simonkraft/cobblestone_02.xpm

1111111111111111111
10W1001001001000001
1011000001000001001
1001001001111101111
1001111000001001001
1111111111111111111
1111              1
1001111111111111111
1111000000000001011
1000000001000000001
1111111111111111111