C 40,,40
F 88,88






NO ./textures/11zon_TILE_1A.xpm
SO ./t=





					1111111111111111111111111
111111111111111111111111111111111111111111111111111111111111
100000000011000000000000111111111111111111111111111
101100000111000000000000111111111111111111111111
1001000000000000000000001111111111111
11111111101100000111000001111111
100000000011000001110111111111111
11110111111111011100000010001
11110111111111011101010010001
11000000110101011100000010001
10000000000000001100000010001
10000000000000001101010010001

11000001110101011111011110N0111
11110111 1110101 101111010001
11111111111111111111111111111