


NO ./textures/11zon_TILE_1A.xpm
SO ./textures/11zon_BRICK_3B.xpm
WE ./textures/11zon_BRICK_3D.xpm

EA ./textures/11zon_BRICK_6D.xpm






C 40,40, 			40

F 88,88,    88






1111111111111111111111111
111111111111111111111111111
111111111111111110010011111111111111
10000000000W00000001000001
1111111111111100001000111111111111111
1111111111111111010111101
11111111111111111111111001111
11111111111111      11111111111
1							1
111111111111        1111111111111
